####################
#        #         #
# P      #         #
#        R         #
#  r     #         #
#        #         #
####################
