####################
#                  #
# #####            #
# #   B b    @     #
# # R #            #
# #  y#            #
# #####            #
#                  #
#   ##########     #
#    #       #     #
#    # #  ##       #
#      #   ###     #
#   ####           #
#    #             #
#    #  #   # #    #
#       #   # #    #
#    ###    ###    #
#      ##Y##       #
#      #   #       #
#      # E #       #
####################
