####################
#                  #
# #####            #
# #   B b    @     #
# # R #            #
# #   #            #
# #####            #
#                  #
#   ##########     #
#    #       #     #
#    # #  ##       #
#      #   ###     #
#   ####           #
#    #             #
#    #  #   # #    #
#       #   # #    #
#    ###    ###    #
#                  #
#                  #
#                  #
####################
