##########
#        #
# P      #
#        #
##########
