##########
#@       #
#      E #
#        #
##########
