##########
#@       #
#        #
#        #
##########
