####################
#        #         #
#@       #         #
#        B         #
#  b     #         #
#        #         #
####################
