####################
#        #       E #
#@       #         #
#        B         #
#  b     #         #
#        #         #
####################
