##########
#       b#
#@   V   #
#        #
###### H #
#    #   #
#    ##B##
#    #E  #
##########
