#####################
#        V#         #
#         #         #
#               @  H#
###H    # p #    H###
#H                  #
#         #         #
#         #V        #
#    ################
#    # # #   #  b   #
# @  P B Y E # ###P #
#    # # #   #   #  #
#    ########### # B#
#                #  #
#           ######P #
#                #  #
#                # B#
#                #  #
################ #P #
#yR  B         P    #
#####################
