########
#@     #
# #  E #
#      #
########
