####################
#                  #
# ################ #
# #E             # #
# #   ##P##Y##B### #
# #   #            #
# #   P            #
# #   #            #
# #   #      @     #
# #   Y            #
# #   #            #
# #   #            #
# #   B            #
# #   #            #
# ##### p   b   y  #
#                  #
####################
