##########
#   #    #
#   #    #
#        #
##########
