#####################
#            V      #
#                E  #
#        V          #
##### ###############
# # R # R # R # R # #
# #   #   #   #   # #
# ##B###B###B###B## # 
#                   #
#    ###########    #
#                   #
# ##B###B###B###B## #
# #   #   #b  #   # #
# # R # R #  @# R # #
#####################
