#####
#  @#
#  E#
#@  #
#####
