#####
#@  #
#  E#
# A #
#####
