#####
#@  #
#  E#
# рР#
#####
