#####
#   #
#  E#
#   #
#####
